悪: 
安: 十女
暗: 日卜廿日
医: 
委: 竹木女
意: 卜廿日心
育: 卜戈月
員: 口月山金
院: 弓中十一山
飲: 人戈弓人
運: 卜月十十
泳: 水戈弓水
駅: 
央: 中月大
横: 
屋: 尸一戈土
温: 
化: 人心
荷: 廿人一口
界: 田人中中
開: 日弓一廿
階: 土心心日 * 弓中心心日
寒: 十廿金卜
感: 戈口心
漢: 水廿中人
館: 人戈十口口 * 人口十口口
岸: 山一一十
起: 土人口山 * 土人尸山
究: 十金大弓
期: 廿金月
客: 十竹水口
急: 弓一心 * 弓尸心
級: 女火弓竹水
宮: 十口竹口
球: 一土戈十水
去: 土戈
橋: 木竹大月
業: 廿金廿木
曲: 廿田 * 難廿田
局: 尸尸口
銀: 金日女
区: 
苦: 廿十口
係: 人竹女火
具: 月一一金
君: 尸大口
軽: 
血: 竹月廿
決: 水木大 * 戈一木大
研: 一口一十十 * 一口一廿
県: 
庫: 戈十田十
湖: 水十口月
向: 竹月口
幸: 土廿十
港: 水廿金山
号: 
根: 木日女
祭: 月人一一火
皿: 月廿
仕: 人土
死: 一弓心
使: 人十中大
始: 女戈口
指: 手心日
歯: 
詩: 卜口土木戈
次: 戈一弓人 * 一一弓人
事: 十中中弓
持: 手土木戈
式: 戈心一
実: 
写: 
者: 十大日
主: 卜土
守: 十木戈
取: 尸十水
酒: 水一金田
受: 月月水
州: 戈中戈中 * 一中一中
拾: 手人一口
終: 女火竹水卜
習: 尸一竹日
集: 人土木
住: 人卜土
重: 竹十田土
宿: 十人一日
所: 竹尸竹一中
暑: 日十大日
助: 月一大尸
昭: 日尸竹口
消: 水火月
商: 卜金月口
章: 卜廿日十
勝: 月火手尸
乗: 
植: 木十月一
申: 中田中
身: 竹難竹
神: 戈火中田中
真: 十月一金
深: 水月金木
進: 卜人土
世: 心廿
昔: 廿日
全: 人一土
整: 木大一卜一
相: 木月山
送: 卜廿大
想: 木山心
息: 竹山心
速: 卜木中
族: 卜尸人人大
他: 人心木
打: 手一弓
対: 
待: 竹人土木戈
代: 人戈心
第: 竹弓中竹
炭: 山一火
短: 人大一口廿
題: 日人一月金
談: 卜口火火
着: 
注: 水卜土
柱: 木卜土
丁: 一弓
帳: 中月尸一女
調: 卜口月土口 * 卜口月手口
追: 卜竹口口
定: 十一卜人
庭: 戈弓大土
笛: 竹中田
都: 十日弓中
鉄: 
転: 
度: 戈廿水
投: 手竹弓水
豆: 一口廿
島: 竹日卜山
湯: 水日一竹
登: 弓人一口廿
等: 竹土木戈
動: 竹土大尸
童: 卜廿田土
農: 木木一一女 * 廿田一一女
波: 水木竹水
配: 一田尸山
畑: 
倍: 人卜廿口
箱: 竹木月山
発: 
反: 竹水
坂: 
板: 木竹水 * 難木竹水
皮: 木竹水
悲: 中卜心
美: 廿土大
鼻: 竹山田一中 * 竹山田廿
筆: 竹中手
氷: 
表: 手一女
秒: 竹木火竹
病: 大一人月
品: 口口口
負: 弓月山金 * 尸竹月山金
部: 卜口弓中
服: 月尸中水
福: 戈火一口田
物: 竹手心竹竹
平: 一火十
返: 卜竹水
勉: 弓山大尸
放: 卜尸人大
味: 口十木
命: 人一口中
面: 一田尸中
問: 日弓口
役: 竹人竹弓水
薬: 
由: 中田
油: 水中田
有: 大月
遊: 卜卜尸木
予: 弓戈弓弓
羊: 廿手
洋: 水廿手
葉: 廿心廿木
陽: 弓中日一竹
様: 
落: 廿水竹口
流: 水卜戈山
旅: 卜尸人竹女
両: 
緑: 
礼: 
列: 一弓中弓
練: 女火木田火
路: 口一竹水口
和: 竹木口
