愛: 月月心水
案: 十女木
以: 女戈人
衣: 卜竹女
位: 人卜廿
囲: 
胃: 田月
印: 竹心尸中
英: 廿中月大
栄: 
塩: 
億: 人卜廿心
加: 大尸口
果: 廿田木 * 田木
課: 卜口田木
芽: 廿一女竹
貨: 人心月山金
改: 尸山人大
械: 木戈廿
害: 十手十口 * 十手一口
街: 竹人土土弓
各: 竹水口
覚: 
完: 十一一山
官: 十口中口
管: 竹十口口
関: 
観: 
季: 竹木弓木
願: 一火一月金
希: 大大中月
紀: 女火尸山
喜: 土口廿口
旗: 卜尸人廿金
器: 口口戈大口
機: 木女戈戈
議: 卜口廿土戈
求: 戈十水
泣: 水卜廿
救: 戈水人大
給: 女火人一口
挙: 
漁: 水弓田火
鏡: 金卜廿山
共: 廿金
協: 十大尸尸 * 心大尸尸
競: 卜山卜廿山
極: 木一水一
訓: 卜口中中中
軍: 月十田十
郡: 尸口弓中
径: 
型: 一弓土
景: 日卜口火
芸: 廿一一戈
欠: 弓人
結: 女火土口
建: 弓大中手
固: 田十口
健: 人弓大手
験: 
功: 一大尸
好: 女弓木
候: 人中弓大
航: 竹卜卜竹弓
康: 戈中水
告: 竹土口
差: 廿手一
菜: 廿月木
最: 日尸十水
材: 木木竹
昨: 日人尸
札: 木山
刷: 尸月中弓
察: 十月人火
参: 
殺: 大金竹弓水 * 大木竹弓水
産: 
散: 廿月人大
残: 
士: 十一
氏: 竹女心
史: 中大
司: 尸一口
試: 卜口戈心一
児: 
治: 水戈口
辞: 
種: 竹木竹十土
失: 竹手人
借: 人廿日
周: 月土口 * 月手口
祝: 戈火口竹山
順: 中中中金
初: 中尸竹
松: 木金戈
笑: 竹竹大
唱: 口日日
焼: 
象: 弓日心人
照: 日口火
賞: 火月口月金
臣: 尸中尸中
省: 火竹月山
信: 人卜一口
成: 戈竹尸
清: 水手一月
静: 
席: 戈廿中月
積: 竹木手一金
折: 手竹一中
節: 竹日戈中
説: 
浅: 
戦: 
選: 卜口山金
然: 月大火
争: 
倉: 人戈日口
巣: 
束: 木中
側: 人月金弓
続: 
卒: 卜人人十
孫: 弓木竹女火
帯: 
隊: 弓中廿心人
達: 卜土廿手
単: 
置: 田中十月一
仲: 人中
貯: 月金十一弓
兆: 中一山人
腸: 月日一竹
底: 戈竹心一
停: 人卜口弓
低: 人竹心一
的: 竹日心戈
典: 廿月金
伝: 人一一戈
徒: 竹人土卜人
努: 女水大尸
灯: 
堂: 火月口土
働: 
特: 竹手土木戈
得: 竹人日一戈
毒: 手一田卜戈
熱: 土戈火
敗: 月金人大
梅: 木人田卜
念: 人戈弓心
博: 十戈月戈
飯: 人戈竹水
飛: 竹田弓人人 * 弓人竹廿人
費: 中弓月山金
必: 心竹
票: 一田一一火
標: 木一田火
不: 一火
夫: 手人
付: 人木戈
府: 戈人木戈
兵: 人一金
副: 一田中弓
粉: 火木金尸竹
別: 口尸中弓
辺: 
変: 
便: 人一中大
包: 心口山
法: 水土戈
望: 卜月竹土
牧: 竹手人大
末: 木十
満: 
未: 十木
脈: 月竹竹女 * 月戈弓水
約: 女火心戈 * 女火心一
民: 口女心
無: 人廿火
勇: 弓月大尸
要: 一田女
養: 廿人戈日女
浴: 水金人口
利: 竹木中弓
陸: 弓中土金土
良: 戈日女
料: 火木卜十
量: 日一田土
輪: 十十人一月
類: 火大一月金
令: 人戈弓戈
歴: 
冷: 戈一人戈戈
例: 人一弓弓
連: 卜十田十
老: 十大心
労: 
録: 
