圧: 
移: 竹木弓戈弓
因: 田大
永: 戈弓水
営: 
衛: 竹人木月弓 * 竹人木手弓
易: 日心竹竹
益: 廿金月廿
液: 水卜人大
演: 水十一金
応: 
往: 竹人卜土
桜: 
恩: 田大心
可: 一弓口
仮: 
価: 
河: 水一弓口
過: 卜月月口
賀: 大口月山金
快: 心木大
解: 弓月尸竹手 * 弓月廿手
格: 木竹水口
確: 一口十人土 * 一口人月土
額: 十口一月金
刊: 一十中弓
眼: 月山日女
幹: 十十人一十
慣: 心田十金
基: 廿金土
寄: 十大一口
規: 手人月山山
技: 手十水
義: 戈大 * 廿土竹手戈 * 難戈大
逆: 卜廿山
久: 弓人 * 難弓人
旧: 
居: 尸十口
許: 卜口人十
境: 土卜廿山
均: 土心戈一 * 土心一一
句: 心口
群: 尸口廿手
禁: 木木一一火
経: 
潔: 水手竹火
件: 人竹手
券: 火手尸竹
険: 
検: 
限: 弓中日女
現: 一土月山山
減: 水戈竹口
故: 十口人大
個: 人田十口
効: 
厚: 一日弓木
護: 卜口廿人水
耕: 手木廿廿
鉱: 
構: 木廿廿月
興: 竹難月金
講: 卜口廿廿月
混: 水日心心
査: 
再: 一土月
災: 女女火
妻: 十中女
採: 手月木
際: 弓中月人火
在: 大中土
財: 月金木竹
罪: 竹山卜廿十 * 田中中一卜
雑: 
酸: 一田戈金水
賛: 
支: 十水
志: 土心
枝: 木十水
師: 竹口一中月
資: 戈人月山金 * 一人月山金
飼: 人戈尸一口
識: 卜口卜戈日
示: 一一火
似: 人女戈人
質: 竹十月金 * 竹中月山金
舎: 
謝: 卜口竹竹戈
授: 手月月水
修: 人中人竹
述: 卜戈木 * 卜戈十金
術: 竹人戈金弓
準: 水土十
序: 戈弓戈弓
招: 手尸竹口
承: 弓弓手人
状: 
証: 卜口一卜一
条: 
常: 火月口中月
情: 心手一月
織: 女火卜戈日
職: 尸十卜戈日
制: 竹月中弓
性: 心竹手一
政: 一一人大
勢: 土戈大尸
精: 火木手一月
製: 竹弓卜竹女
税: 
責: 手一月山金
接: 手卜廿女
設: 卜口竹弓水
績: 女火手一金
舌: 竹十口 * 一十口
絶: 
銭: 
祖: 戈火月一
素: 手一女戈火
総: 
造: 卜竹土口 * 卜竹手口
像: 人弓日人
増: 
則: 月金中弓
測: 水月金弓
属: 
率: 卜戈人十
損: 手口月金
退: 卜日女
貸: 人心月山金 * 難人心月山
態: 戈心心
団: 
断: 
築: 竹一弓木
張: 弓尸一女
提: 手日一人
程: 竹木口竹土 * 竹木口一土
適: 卜卜金月
敵: 卜月人大
統: 女火卜戈山
銅: 金月一口
導: 卜山木戈
徳: 
独: 
任: 人竹土
燃: 火月大火
能: 戈月心心
破: 一口木竹水
犯: 大竹尸山
判: 火手中弓
版: 中中竹水
比: 心心
肥: 月日山
非: 中一尸卜
備: 人廿竹月
俵: 人手一女
評: 卜口一火十
貧: 金尸竹金
布: 大中月
婦: 女尸一月
富: 十一口田
武: 一心卜中一
復: 竹人人日水
複: 中人日水
仏: 
編: 女火竹尸月
墓: 廿日大土
弁: 戈廿 * 難戈廿
保: 人口木
報: 土十尸中水
豊: 廿田一口廿
防: 弓中卜竹尸
貿: 竹竹月山金
暴: 日廿金水
務: 弓竹竹水尸 * 弓竹人大尸
夢: 廿田中弓
迷: 卜火木
綿: 竹月竹女火 * 女火竹日月
輸: 十十人一弓 * 十十人一女
余: 人一木
預: 弓弓一月金
容: 十金人口
略: 田竹水口
留: 竹竹田
領: 人戈一月金
