異: 田廿金
遺: 卜中一金
域: 土戈口一
宇: 十一木
映: 日中月大
延: 弓大竹卜一
沿: 水金口 * 水竹弓口
我: 竹手戈
灰: 大火
拡: 
革: 廿中十
閣: 日弓竹水口
株: 木竹十木
干: 一十
割: 十口中弓
巻: 
看: 竹手月山
簡: 竹日弓日
危: 弓一尸山
机: 木竹弓
揮: 手月十十
貴: 中一月山金
疑: 心大弓戈人
吸: 口弓竹水
郷: 
供: 人廿金
胸: 月心山大
勤: 廿一大尸
筋: 竹月大尸
系: 竹女戈火
敬: 廿口人大
警: 廿大卜一口
劇: 難卜人中弓 * 卜人中弓
激: 水竹尸大
穴: 十金
絹: 女火口月
権: 
憲: 十手一心
厳: 
源: 水一竹火
己: 尸山
呼: 口竹火木
誤: 卜口口女大
后: 竹一口
孝: 十大弓木
皇: 竹日一土
紅: 女火一
降: 弓中竹水手
鋼: 金月廿山
刻: 卜人中弓
穀: 土木竹弓水
骨: 月月月
困: 田木 * 難田木
砂: 一口火竹
座: 戈人人土
済: 
裁: 十戈卜竹女
策: 竹木月
冊: 月月一 * 月廿 * 難月廿
蚕: 竹大中一戈
至: 一戈土
私: 竹木戈
姿: 戈人女 * 一人女
誌: 卜口土心
視: 戈火月山山
詞: 卜口尸一口
磁: 一口廿女戈
射: 竹竹木戈
捨: 手人一口 * 難手人一口
尺: 尸人
若: 廿大口
樹: 木土廿戈
収: 
宗: 十一一火
就: 卜火戈大山
衆: 
従: 
縦: 
縮: 女火十人日
熟: 卜戈火
純: 女火心山
処: 
署: 田中十大日
諸: 卜口十大日
除: 弓中人一木
将: 
傷: 人人日竹
障: 弓中卜廿十
城: 土戈竹尸
蒸: 廿弓水火
仁: 人一一
針: 金十
垂: 竹十廿一
推: 手人土
寸: 木戈
盛: 戈尸月廿
聖: 尸口竹土
誠: 卜口戈竹尸
宣: 十一日一
専: 
泉: 竹日水
洗: 水竹土山
染: 水弓木
善: 廿土廿口 * 廿廿口
奏: 手大竹大
窓: 
創: 人口中弓
装: 
層: 尸金田日
操: 手口口木
蔵: 
臓: 
存: 大中弓木
尊: 廿田木戈
宅: 十竹心
担: 
誕: 卜口弓大一
段: 竹十竹弓水
探: 手月金木
暖: 日月一水
値: 
宙: 十中田
忠: 中心
著: 廿十大日 * 廿手月山
庁: 
頂: 一弓一月金
潮: 水十十月
賃: 人土月山金
痛: 大弓戈月
展: 尸廿女
討: 卜口木戈
党: 火月口竹山
糖: 火木戈中口
届: 
難: 廿人人土
乳: 月木山
認: 卜口尸戈心
納: 女火人月
脳: 
派: 水竹竹女
拝: 
俳: 人中一卜
背: 中心月
肺: 月十月 * 月卜中月
班: 一土戈中土
晩: 
否: 一火口
批: 手心心
秘: 竹木心竹
腹: 月人日水
奮: 大人土田
並: 廿廿金 * 廿廿一
陛: 弓中心心土
閉: 日弓木竹
片: 中中一中
補: 中戈十月
暮: 廿日大日
宝: 
訪: 卜口卜竹尸
亡: 卜女
忘: 卜女心
棒: 木手大手
枚: 木人大
幕: 廿日大月
密: 十心竹山
盟: 日月月廿
模: 木廿日大
訳: 
優: 人一月水
幼: 女戈大尸
郵: 竹一弓中
欲: 金口弓人
翌: 尸一卜廿
乱: 
卵: 竹竹尸中戈
覧: 
裏: 卜田土女
律: 竹人中手
臨: 尸中人口口
朗: 戈戈月
論: 卜口人一月
